"date","Hospital_Intake_Proven","Hospital_Intake_Suspected","IC_Intake_Proven","IC_Intake_Suspected","IC_Current","ICs_Used","IC_Cumulative","Hospital_Currently","IC_Deaths_Cumulative","IC_Discharge_Cumulative","IC_Discharge_InHospital","Hospital_Cumulative","Hospital_Intake","IC_Intake","Hosp_Intake_Suspec_Cumul","IC_Intake_Suspected_Cumul","IC_Intake_Proven_Cumsum"
2020-02-27,2,2,1,0,8,6,8,48,0,0,0,50,4,1,2,0,1
2020-02-28,3,0,0,1,9,7,9,51,0,0,0,53,3,1,2,1,1
2020-02-29,1,0,0,0,10,6,10,51,0,0,0,54,1,0,2,1,1
2020-03-01,7,1,2,0,12,7,12,59,0,0,1,62,8,2,3,1,3
2020-03-02,10,1,0,0,11,6,12,70,0,0,1,73,11,0,4,1,3
2020-03-03,8,0,1,0,13,6,14,77,0,0,1,81,8,1,4,1,4
2020-03-04,10,3,3,0,16,8,17,89,0,2,1,94,13,3,7,1,7
2020-03-05,12,1,1,1,16,10,19,99,0,2,1,106,13,2,8,2,8
2020-03-06,18,1,4,0,20,13,23,114,0,2,2,122,19,4,9,2,12
2020-03-07,7,3,3,0,22,14,26,123,0,3,1,131,10,3,12,2,15
2020-03-08,17,5,6,0,28,18,32,141,2,3,1,151,22,6,17,2,21
2020-03-09,26,5,5,2,33,20,40,165,2,3,2,180,31,7,22,4,26
2020-03-10,28,4,9,1,40,21,50,188,2,3,2,209,32,10,26,5,35
2020-03-11,43,6,9,0,49,23,60,225,4,3,2,253,49,9,32,5,44
2020-03-12,55,4,23,0,69,29,83,270,5,3,2,306,59,23,36,5,67
2020-03-13,73,6,13,0,80,32,97,337,5,4,2,382,79,13,42,5,80
2020-03-14,62,3,18,0,97,40,116,378,5,7,5,439,65,18,45,5,98
2020-03-15,70,8,27,1,121,48,145,427,7,7,6,511,78,28,53,6,125
2020-03-16,140,19,32,0,151,54,178,558,13,8,6,664,159,32,72,6,157
2020-03-17,144,13,35,0,180,57,215,644,15,8,9,805,157,35,85,6,192
2020-03-18,171,16,50,0,229,61,269,766,18,12,10,978,187,50,101,6,242
2020-03-19,249,26,59,2,288,69,336,968,26,12,12,1240,275,61,127,8,301
2020-03-20,238,27,82,1,363,70,423,1144,31,14,17,1488,265,83,154,9,383
2020-03-21,199,13,72,3,431,70,505,1227,43,16,26,1674,212,75,167,12,455
2020-03-22,236,19,72,1,481,70,579,1332,49,19,27,1902,255,73,186,13,527
2020-03-23,443,24,98,3,574,71,682,1650,66,22,39,2331,467,101,210,16,625
2020-03-24,420,25,107,1,654,73,795,1903,75,26,44,2741,445,108,235,17,732
2020-03-25,432,24,114,2,753,74,914,2118,88,31,52,3154,456,116,259,19,846
2020-03-26,433,34,104,4,839,74,1028,2313,106,41,54,3578,467,108,293,23,950
2020-03-27,556,36,113,1,928,74,1148,2576,121,47,71,4116,592,114,329,24,1063
2020-03-28,293,27,99,2,993,74,1253,2512,140,51,87,4392,320,101,356,26,1162
2020-03-29,253,18,86,3,1039,74,1345,2467,165,62,98,4621,271,89,374,29,1248
2020-03-30,437,29,126,3,1127,74,1477,2614,185,71,117,5024,466,129,403,32,1374
2020-03-31,307,42,109,1,1192,74,1590,2544,219,89,125,5317,349,110,445,33,1483
2020-04-01,312,42,72,3,1209,75,1664,2451,244,107,135,5626,354,75,487,36,1555
2020-04-02,350,41,88,3,1250,75,1761,2432,266,121,148,5963,391,91,528,39,1643
2020-04-03,330,56,76,0,1277,75,1840,2435,298,142,156,6309,386,76,584,39,1719
2020-04-04,186,24,62,3,1281,74,1906,2225,317,156,173,6479,210,65,608,42,1781
2020-04-05,225,21,72,3,1305,75,1984,2173,340,165,194,6677,246,75,629,45,1853
2020-04-06,321,56,60,1,1313,75,2047,2292,358,189,207,7014,377,61,685,46,1913
2020-04-07,204,54,55,2,1315,76,2107,2158,388,211,240,7236,258,57,739,48,1968
2020-04-08,208,32,55,0,1282,76,2166,2022,405,236,252,7442,240,55,771,48,2023
2020-04-09,187,38,50,1,1278,76,2218,1847,417,264,257,7631,225,51,809,49,2073
2020-04-10,202,38,48,1,1285,75,2269,1756,445,293,264,7839,240,49,847,50,2121
2020-04-11,132,20,26,2,1250,75,2298,1566,460,313,285,7970,152,28,867,52,2147
2020-04-12,135,33,34,1,1232,75,2334,1508,475,331,313,8122,168,35,900,53,2181
2020-04-13,166,33,43,1,1215,75,2379,1502,496,346,338,8289,199,44,933,54,2224
2020-04-14,163,37,34,2,1192,76,2416,1521,506,397,332,8464,200,36,970,56,2258
2020-04-15,117,17,23,1,1167,76,2441,1431,523,453,328,8580,134,24,987,57,2281
2020-04-16,115,23,28,2,1134,76,2471,1318,541,503,313,8696,138,30,1010,59,2309
2020-04-17,137,27,25,1,1104,77,2497,1274,559,550,313,8836,164,26,1037,60,2334
2020-04-18,78,14,19,0,1058,76,2516,1129,570,573,329,8909,92,19,1051,60,2353
2020-04-19,82,15,19,1,1029,76,2536,1103,589,579,351,8989,97,20,1066,61,2372
2020-04-20,109,24,25,1,1010,76,2563,1143,608,635,335,9096,133,26,1090,62,2397
2020-04-21,116,26,20,0,973,76,2585,1098,629,687,333,9212,142,20,1116,62,2417
2020-04-22,89,23,14,0,917,77,2600,1017,645,733,328,9311,112,14,1139,62,2431
2020-04-23,95,36,16,0,875,77,2616,975,658,780,306,9426,131,16,1175,62,2447
2020-04-24,78,26,17,1,858,76,2635,921,668,842,273,9514,104,18,1201,63,2464
2020-04-25,44,23,13,0,828,76,2649,795,682,859,278,9573,67,13,1224,63,2477
2020-04-26,43,27,13,0,804,76,2662,770,692,868,293,9632,70,13,1251,63,2490
2020-04-27,60,17,14,0,781,76,2676,755,703,877,310,9698,77,14,1268,63,2504
2020-04-28,91,28,14,1,760,76,2692,772,709,927,295,9797,119,15,1296,64,2518
2020-04-29,58,21,11,0,732,76,2704,714,715,963,296,9859,79,11,1317,64,2529
2020-04-30,62,24,17,2,708,76,2723,693,728,1006,281,9934,86,19,1341,66,2546
2020-05-01,51,11,9,0,673,76,2732,636,730,1047,283,9985,62,9,1352,66,2555
2020-05-02,27,14,9,2,635,76,2743,550,739,1062,283,10021,41,11,1366,68,2564
2020-05-03,36,10,10,0,621,76,2754,531,744,1069,297,10058,46,10,1376,68,2574
2020-05-04,58,25,11,2,612,76,2766,578,750,1112,291,10128,83,13,1401,70,2585
2020-05-05,28,8,3,0,570,76,2769,509,755,1126,305,10160,36,3,1409,70,2588
2020-05-06,59,17,5,0,543,73,2775,525,761,1164,296,10226,76,5,1426,70,2593
2020-05-07,46,16,8,1,520,72,2785,501,769,1203,290,10277,62,9,1442,71,2601
2020-05-08,53,26,7,1,489,72,2793,499,773,1239,277,10351,79,8,1468,72,2608
2020-05-09,29,7,5,0,467,72,2798,449,778,1248,285,10383,36,5,1475,72,2613
2020-05-10,25,15,4,1,449,72,2803,435,779,1251,294,10417,40,5,1490,73,2617
2020-05-11,44,22,7,1,443,73,2811,465,786,1289,292,10478,66,8,1512,74,2624
2020-05-12,25,31,2,0,401,71,2813,442,789,1332,269,10530,56,2,1543,74,2626
2020-05-13,37,29,3,1,383,71,2817,425,794,1367,267,10590,66,4,1572,75,2629
2020-05-14,25,19,8,1,357,71,2826,392,798,1394,254,10626,44,9,1591,76,2637
2020-05-15,31,23,3,1,341,71,2831,373,805,1427,235,10675,54,4,1614,77,2640
2020-05-16,17,6,7,1,325,70,2839,326,807,1436,235,10694,23,8,1620,78,2647
2020-05-17,30,12,4,0,318,70,2843,339,808,1440,239,10731,42,4,1632,78,2651
2020-05-18,36,22,4,0,313,70,2847,379,808,1472,242,10785,58,4,1654,78,2655
2020-05-19,17,13,1,1,280,67,2849,356,810,1504,222,10813,30,2,1667,79,2656
2020-05-20,31,17,2,0,270,66,2852,344,815,1535,207,10855,48,2,1684,79,2658
2020-05-21,14,6,2,0,249,66,2854,305,819,1541,213,10870,20,2,1690,79,2660
2020-05-22,32,19,4,0,238,66,2859,333,822,1574,197,10915,51,4,1709,79,2664
2020-05-23,13,8,3,0,221,63,2862,289,823,1577,201,10933,21,3,1717,79,2667
2020-05-24,18,16,7,0,220,63,2869,282,824,1577,211,10958,34,7,1733,79,2674
2020-05-25,35,21,1,0,210,62,2870,317,825,1600,215,11009,56,1,1754,79,2675
2020-05-26,25,13,4,0,187,63,2874,310,829,1621,206,11044,38,4,1767,79,2679
2020-05-27,16,13,3,1,173,59,2878,280,830,1644,191,11069,29,4,1780,80,2682
2020-05-28,16,10,1,0,165,58,2879,258,832,1675,171,11090,26,1,1790,80,2683
2020-05-29,24,14,1,2,155,57,2882,261,835,1696,158,11123,38,3,1804,82,2684
2020-05-30,20,5,3,0,146,55,2885,241,835,1703,153,11145,25,3,1809,82,2687
2020-05-31,12,8,4,0,149,55,2889,234,835,1703,160,11164,20,4,1817,82,2691
2020-06-01,15,7,4,0,146,54,2893,239,838,1703,163,11182,22,4,1824,82,2695
2020-06-02,24,17,1,0,141,54,2894,261,838,1727,156,11218,41,1,1841,82,2696
2020-06-03,17,11,4,0,128,51,2898,252,843,1748,139,11238,28,4,1852,82,2700
2020-06-04,14,19,5,1,126,53,2904,239,846,1768,121,11263,33,6,1871,83,2705
2020-06-05,9,12,3,0,124,52,2907,222,846,1778,114,11281,21,3,1883,83,2708
2020-06-06,4,5,2,0,122,52,2909,183,847,1780,115,11288,9,2,1888,83,2710
2020-06-07,4,12,3,0,121,51,2912,182,847,1782,115,11302,16,3,1900,83,2713
2020-06-08,11,7,0,0,120,50,2913,182,847,1798,108,11320,18,0,1907,83,2713
2020-06-09,9,9,2,0,112,49,2915,160,848,1810,100,11336,18,2,1916,83,2715
2020-06-10,5,6,2,0,109,49,2917,143,849,1821,92,11345,11,2,1922,83,2717
2020-06-11,14,11,1,0,105,49,2918,149,849,1833,85,11366,25,1,1933,83,2718
2020-06-12,8,4,3,0,102,48,2921,141,850,1843,79,11377,12,3,1937,83,2721
2020-06-13,4,5,2,0,100,46,2923,120,851,1843,79,11384,9,2,1942,83,2723
2020-06-14,3,5,0,0,99,45,2923,119,853,1845,77,11392,8,0,1947,83,2723
2020-06-15,5,5,1,0,98,45,2924,122,854,1863,69,11401,10,1,1952,83,2724
2020-06-16,8,9,2,0,89,44,2926,122,857,1868,68,11417,17,2,1961,83,2726
2020-06-17,7,6,0,0,81,42,2926,114,858,1874,68,11428,13,0,1967,83,2726
2020-06-18,4,12,1,0,74,41,2927,116,859,1881,68,11443,16,1,1979,83,2727
2020-06-19,4,8,0,0,69,39,2928,113,860,1889,61,11454,12,0,1987,83,2727
2020-06-20,4,5,2,0,67,39,2930,94,861,1890,64,11460,9,2,1992,83,2729
2020-06-21,4,10,0,0,63,37,2930,96,862,1890,64,11473,14,0,2002,83,2729
2020-06-22,7,8,3,0,65,39,2933,100,863,1895,66,11487,15,3,2010,83,2732
2020-06-23,6,9,1,0,58,36,2934,99,864,1901,64,11497,15,1,2019,83,2733
2020-06-24,4,11,1,1,55,36,2936,95,865,1907,60,11511,15,2,2030,84,2734
2020-06-25,9,8,1,1,54,34,2938,102,865,1913,60,11526,17,2,2038,85,2735
2020-06-26,3,6,0,0,48,31,2938,98,866,1917,60,11533,9,0,2044,85,2735
2020-06-27,1,2,0,0,43,29,2938,76,867,1917,63,11536,3,0,2046,85,2735
2020-06-28,4,5,0,0,39,28,2938,78,867,1917,63,11545,9,0,2051,85,2735
2020-06-29,8,8,0,0,39,28,2938,90,867,1921,62,11558,16,0,2059,85,2735
2020-06-30,2,6,2,0,38,27,2940,75,867,1928,58,11564,8,2,2065,85,2737
2020-07-01,3,5,0,0,34,24,2940,70,867,1932,55,11572,8,0,2070,85,2737
2020-07-02,4,3,2,1,36,27,2943,64,868,1936,53,11576,7,3,2073,86,2739
2020-07-03,7,5,0,0,33,26,2943,65,868,1944,45,11586,12,0,2078,86,2739
2020-07-04,0,3,1,0,34,26,2944,55,868,1944,47,11588,3,1,2081,86,2740
2020-07-05,2,8,0,0,32,24,2944,59,868,1945,47,11596,10,0,2089,86,2740
2020-07-06,2,5,1,0,32,24,2945,63,869,1950,44,11603,7,1,2094,86,2741
2020-07-07,3,5,1,0,30,22,2946,66,870,1953,43,11610,8,1,2099,86,2742
2020-07-08,4,7,2,0,27,22,2948,67,870,1958,39,11620,11,2,2106,86,2744
2020-07-09,6,7,1,0,27,21,2949,70,870,1962,35,11630,13,1,2113,86,2745
2020-07-10,6,7,1,0,28,21,2950,79,870,1962,36,11641,13,1,2120,86,2746
2020-07-11,2,2,0,0,26,19,2950,68,870,1962,36,11644,4,0,2122,86,2746
2020-07-12,3,4,1,0,27,19,2951,69,871,1964,35,11648,7,1,2126,86,2747
2020-07-13,4,5,0,0,26,20,2951,76,872,1965,36,11657,9,0,2131,86,2747
2020-07-14,5,7,0,0,23,20,2951,78,872,1966,36,11668,12,0,2138,86,2747
2020-07-15,2,4,1,0,23,19,2952,69,872,1969,35,11673,6,1,2142,86,2748
2020-07-16,2,8,1,0,22,19,2953,65,872,1973,31,11682,10,1,2150,86,2749
2020-07-17,6,3,0,0,22,18,2953,64,872,1973,32,11690,9,0,2153,86,2749
2020-07-18,5,7,0,0,21,17,2953,66,872,1973,32,11702,12,0,2160,86,2749
2020-07-19,7,3,1,0,22,17,2954,71,872,1973,33,11712,10,1,2163,86,2750
2020-07-20,4,5,0,1,22,18,2955,75,873,1978,29,11720,9,1,2168,87,2750
2020-07-21,6,7,2,3,25,19,2958,77,873,1980,30,11731,13,5,2175,90,2752
2020-07-22,3,1,1,0,25,19,2959,64,874,1983,28,11734,4,1,2176,90,2753
2020-07-23,9,8,1,0,23,18,2960,71,874,1985,28,11750,17,1,2184,90,2754
2020-07-24,10,0,1,1,22,18,2962,67,874,1989,28,11759,10,2,2184,91,2755
2020-07-25,9,4,1,0,19,16,2963,67,874,1990,29,11771,13,1,2188,91,2756
2020-07-26,4,2,1,0,19,16,2965,69,874,1990,29,11775,6,1,2190,91,2757
2020-07-27,4,6,4,0,23,19,2969,76,874,1991,29,11784,10,4,2196,91,2761
2020-07-28,10,3,0,0,22,18,2969,80,874,1992,28,11797,13,0,2199,91,2761
2020-07-29,4,1,0,0,21,17,2969,74,875,1993,28,11801,5,0,2200,91,2761
2020-07-30,15,3,3,0,23,18,2972,79,875,1995,26,11818,18,3,2203,91,2764
2020-07-31,10,1,4,0,26,20,2976,81,877,1995,25,11827,11,4,2204,91,2768
2020-08-01,8,4,2,0,27,20,2978,83,877,1996,25,11838,12,2,2208,91,2770
2020-08-02,10,2,2,0,28,21,2980,91,877,1996,25,11849,12,2,2210,91,2772
2020-08-03,15,5,3,0,31,22,2983,103,877,1996,26,11868,20,3,2215,91,2775
2020-08-04,8,5,3,0,33,24,2986,99,879,1997,26,11879,13,3,2220,91,2778
2020-08-05,8,3,2,0,32,23,2988,95,879,2000,23,11889,11,2,2223,91,2780
2020-08-06,11,2,2,0,34,24,2990,94,880,2001,22,11899,13,2,2225,91,2782
2020-08-07,13,2,1,0,34,23,2991,100,880,2002,22,11914,15,1,2227,91,2783
2020-08-08,16,2,1,0,34,24,2992,106,880,2002,23,11932,18,1,2229,91,2784
2020-08-09,16,6,5,1,39,28,2998,118,882,2003,26,11950,22,6,2235,92,2789
2020-08-10,15,5,4,0,38,29,3002,129,882,2004,26,11970,20,4,2240,92,2793
2020-08-11,26,6,3,1,41,29,3005,148,883,2005,28,12000,32,4,2246,93,2796
2020-08-12,17,1,4,0,41,28,3009,151,883,2006,33,12015,18,4,2247,93,2800
2020-08-13,19,6,4,0,38,28,3013,150,883,2006,34,12037,25,4,2253,93,2804
2020-08-14,12,6,6,0,43,30,3019,149,883,2007,36,12051,18,6,2259,93,2810
2020-08-15,15,4,1,0,41,29,3020,146,884,2007,38,12070,19,1,2263,93,2811
2020-08-16,15,5,4,0,42,30,3024,152,884,2008,37,12088,20,4,2268,93,2815
2020-08-17,18,10,7,2,51,33,3033,171,886,2011,38,12113,28,9,2278,95,2822
2020-08-18,9,2,2,0,46,33,3035,163,886,2015,37,12122,11,2,2280,95,2824
2020-08-19,16,2,3,0,45,31,3038,163,886,2020,36,12136,18,3,2282,95,2827
2020-08-20,24,3,5,0,46,34,3043,174,887,2023,32,12161,27,5,2285,95,2832
2020-08-21,18,10,6,0,50,34,3049,169,888,2026,32,12185,28,6,2295,95,2838
2020-08-22,10,4,0,0,46,32,3049,148,888,2026,34,12199,14,0,2299,95,2838
2020-08-23,13,1,5,0,49,34,3054,149,888,2027,34,12210,14,5,2300,95,2843
2020-08-24,10,6,1,0,49,35,3056,153,889,2028,40,12224,16,1,2306,95,2844
2020-08-25,18,4,3,0,44,30,3059,159,889,2029,41,12243,22,3,2310,95,2847
2020-08-26,11,6,0,0,42,30,3059,149,889,2034,39,12260,17,0,2316,95,2847
2020-08-27,6,2,2,1,42,30,3062,134,889,2037,40,12267,8,3,2318,96,2849
2020-08-28,12,4,1,0,40,31,3064,139,890,2042,36,12281,16,1,2322,96,2850
2020-08-29,2,2,2,0,40,30,3067,120,890,2043,35,12284,4,2,2324,96,2852
2020-08-30,9,2,3,0,45,32,3070,120,891,2043,36,12295,11,3,2326,96,2855
2020-08-31,17,5,1,0,44,31,3071,135,893,2046,36,12316,22,1,2331,96,2856
2020-09-01,13,5,2,0,40,31,3073,137,894,2049,35,12332,18,2,2336,96,2858
2020-09-02,17,9,0,0,38,30,3074,142,894,2051,35,12356,26,0,2345,96,2858
2020-09-03,8,4,4,0,40,27,3078,132,894,2054,32,12365,12,4,2349,96,2862
2020-09-04,14,8,4,0,44,29,3082,140,895,2055,35,12386,22,4,2357,96,2866
2020-09-05,16,2,1,0,40,29,3083,136,895,2056,35,12404,18,1,2359,96,2867
2020-09-06,21,8,4,0,44,31,3087,153,895,2056,36,12427,29,4,2367,96,2871
2020-09-07,26,6,3,0,45,30,3090,172,895,2056,38,12456,32,3,2373,96,2874
2020-09-08,20,5,3,0,46,28,3094,183,896,2056,42,12480,25,3,2378,96,2877
2020-09-09,32,10,2,0,45,28,3097,201,897,2058,41,12521,42,2,2388,96,2879
2020-09-10,17,6,5,0,48,29,3102,197,898,2060,39,12541,23,5,2394,96,2884
2020-09-11,41,5,6,0,53,31,3108,217,898,2061,40,12580,46,6,2399,96,2890
2020-09-12,19,2,6,0,57,32,3114,214,898,2062,41,12599,21,6,2401,96,2896
2020-09-13,24,6,4,0,59,33,3118,227,898,2062,41,12627,30,4,2407,96,2900
2020-09-14,49,9,8,1,69,35,3128,266,899,2065,41,12683,58,9,2416,97,2908
2020-09-15,38,5,5,0,70,36,3133,275,900,2069,42,12724,43,5,2421,97,2913
2020-09-16,42,13,1,0,65,37,3134,298,901,2070,44,12777,55,1,2434,97,2914
2020-09-17,50,11,4,0,65,38,3138,316,901,2075,42,12834,61,4,2445,97,2918
2020-09-18,66,2,6,0,69,39,3145,338,901,2077,42,12892,68,6,2447,97,2924
2020-09-19,54,8,13,0,80,43,3158,352,902,2079,41,12949,62,13,2455,97,2937
2020-09-20,46,2,14,0,93,45,3173,366,903,2079,44,12988,48,14,2457,97,2951
2020-09-21,76,4,11,0,102,46,3186,413,906,2081,42,13064,80,11,2461,97,2962
2020-09-22,68,7,11,0,110,49,3197,447,906,2083,44,13131,75,11,2468,97,2973
2020-09-23,92,7,11,0,117,51,3208,491,907,2088,43,13223,99,11,2475,97,2984
2020-09-24,99,14,10,0,124,55,3219,543,908,2090,44,13330,113,10,2489,97,2994
2020-09-25,88,8,17,0,138,56,3237,571,910,2094,44,13414,96,17,2497,97,3011
2020-09-26,74,3,12,0,142,58,3249,566,911,2095,49,13484,77,12,2500,97,3023
2020-09-27,76,8,17,2,154,58,3268,599,912,2095,56,13558,84,19,2508,99,3040
2020-09-28,105,4,15,0,162,60,3283,644,915,2098,66,13657,109,15,2512,99,3055
2020-09-29,92,16,22,1,170,61,3306,685,917,2101,74,13754,108,23,2528,100,3077
2020-09-30,106,11,13,2,172,60,3321,709,920,2103,78,13863,117,15,2539,102,3090
2020-10-01,96,22,12,2,178,62,3334,738,924,2110,79,13976,118,14,2561,104,3102
2020-10-02,113,11,12,0,179,62,3349,768,924,2114,85,14089,124,12,2572,104,3114
2020-10-03,129,7,18,0,186,66,3368,787,926,2118,88,14213,136,18,2579,104,3132
2020-10-04,89,13,22,0,199,66,3390,820,931,2122,91,14307,102,22,2592,104,3154
2020-10-05,142,10,27,0,214,65,3419,910,934,2126,95,14450,152,27,2602,104,3181
2020-10-06,137,16,31,0,234,67,3451,962,936,2138,99,14591,153,31,2618,104,3212
2020-10-07,130,13,28,1,247,67,3481,985,940,2149,99,14722,143,29,2631,105,3240
2020-10-08,130,18,22,0,254,68,3504,1008,943,2156,97,14854,148,22,2649,105,3262
2020-10-09,167,22,24,0,270,69,3529,1074,954,2166,104,15026,189,24,2671,105,3286
2020-10-10,132,19,27,0,271,69,3557,1070,957,2176,103,15162,151,27,2690,105,3313
2020-10-11,114,42,19,0,278,68,3577,1129,964,2181,108,15313,156,19,2732,105,3332
2020-10-12,114,75,30,4,300,69,3615,1235,967,2187,111,15483,189,34,2807,109,3362
2020-10-13,12,23,6,2,291,69,3623,1178,967,2187,111,15515,35,8,2830,111,3368
